2 3 11 3 17 597 3 595 
2 2 796 2 797 17 5 17 
797 4 795 593 777 593 778 2 
3 581 797 579 797 595 1 592 
106 96 104 204 236 206 240 97 
106 295 101 385 232 386 233 290 
365 209 367 104 495 103 488 212 
349 385 357 289 480 285 474 389 
603 208 602 110 691 105 688 214 
594 382 593 291 678 282 670 386 
119 500 115 584 225 586 227 504 
356 585 361 505 471 503 480 581 
610 505 614 584 685 588 683 503 

